2020年中国矿山黄金产量、金矿开采及金矿运营分析	Mineral Exploration
ICP-AES法在测定金矿化学成分中的应用研究	World Nonferrous Metals
阿拉善地区金矿成矿规律与找矿预测	世界有色金属
哀牢山南段长安金矿地质特征及找矿方法研究	Acta Geologica Sinica
哀牢山南段长安金矿深部找矿新进展	Contributions to Geology and Mineral Resources Research
哀牢山造山带金矿成矿时序及其动力学背景探讨	Acta Petrologica Sinica
安徽东至县方坑坞—杨树桥地区金矿化特征及成因探讨	资源信息与工程
安徽南部地区金矿控矿条件及其成矿规律研究	Acta Petrologica Sinica
安徽省金矿主要找矿远景区	Geological Review
安徽省金矿资源保障程度研究	中国资源综合利用
安徽石英脉-蚀变岩型金矿成矿条件研究	Geological Review
北祁连西段寒山金矿控矿构造及富集规律	Geology and Exploration
北衙金矿多期热液成矿作用识别：来自地质、岩相学、流体包裹体和H-O-S同位素证据	Acta Petrologica Sinica
测绘新技术在金矿井下测量中的应用研究	中国金属通报
柴北缘苦水泉金矿英云闪长岩和细粒闪长岩年代学、地球化学和Hf同位素及地质意义	Acta Petrologica Sinica
柴北缘赛坝沟金矿深部热液蚀变作用	地质与勘探
柴北缘滩间山地区独树沟金矿花岗斑岩锆石U-Pb年代学、地球化学和Hf同位素	Acta Geologica Sinica
柴北缘滩间山金矿黄铁矿微量元素特征：指示多阶段金矿化事件	The Chinese Journal of Nonferrous Metals
柴北缘造山带滩间山金矿田多期侵入岩年代学及其地质意义	地质与勘探
柴达木盆地北缘造山型金矿地质、成矿流体及成矿时代特征	Geology in China
崇礼县小常峪口金矿成矿地质特征	RESOURCES
打造“一带一路”“金”牌项目 ——河南省自然资源投资集团有限公司实施海外金矿项目纪实	资源导刊
大地幔楔与克拉通破坏型金矿	Scientia Sinica(Terrae)
大功率激电法和连续电导率测深在赤峰-朝阳金矿化集中区快速找矿评价中的应用	Geology and Exploration
大功率激电法在东天山卡拉塔格金岭铜金矿勘查中的应用	Mineral Exploration
大黄山金矿矿床特征及成矿模式研究	中国资源综合利用
大型超大型金矿勘查深部找矿方法研究	中国金属通报
大型矿山中深部金矿资源矿山勘查研究	中国金属通报
大冶市鸡冠咀铜金矿Ⅲ号矿体探采对比研究	Resources Environment & Engineering
大尹格庄金矿田构造蚀变岩相特征研究	Geological Review
当代金矿地质勘查技术与方法研究	中国金属通报
党河南山鸡叫沟金矿控矿因素及成矿模式	Resource Information and Engineering
德兴大型铜金矿集区的研究进展和成矿模式	Acta Petrologica Sinica
德兴推覆型韧性剪切带与金成矿关系 ——以金山金矿田渔塘金矿为例	Mineral Exploration
地磁异常数据处理技术在低纬度地区的应用研究 ——以柬埔寨王国Mesam金矿为例	Geology and Exploration
地电提取测量法在黑龙江金厂外围区寻找隐伏金矿的应用	Journal of Guilin University of Technology
地球电化学方法在秦岭柳梢沟金矿找矿预测中的应用	Journal of Guilin University of Technology
地球电化学提取法在高原寒冷区寻找隐伏金矿——以青海格尔木西藏大沟地区为例	Journal of Guilin University of Technology
地球化学方法在吉家洼金矿区外围找矿中的应用	Journal of Geomechanics
地球化学勘查技术方法在太基敖包金矿勘查中的应用	World Nonferrous Metals
地球物理找矿方法在东杜奥巴—上库马尔克金矿勘查中的应用	Resource Information and Engineering
地球物理找矿方法在胶东招平金矿带厚覆盖区深部找矿中的应用	World Nonferrous Metals
地质构造对西成多金属矿田内金矿带成矿的影响	中文科技期刊数据库(全文版)工程技术
地质数字信息化及资料二次开发研究在胜利沟金矿的找矿应用	Mineral Exploration
地质冶金学在金矿开发中的应用探索	World Nonferrous Metals
低硫化型与高硫化型浅成低温热液金矿蚀变特征与成矿关系的对比研究	Geology and Exploration
滇东南富宁地区“半瓦型”辉绿岩地球化学特征及其与金矿成矿关系	Geology and Exploration
滇西保山黑牛凹金矿矿床特征及找矿标志	RESOURCES
滇西普朗铜金矿成矿地质条件及找矿潜力初探	Contributions to Geology and Mineral Resources Research
典型露天矿山生态修复模式探讨——以山东省归来庄金矿为例	山东国土资源
电法勘探技术在蚀变岩型金矿找矿工作中的应用	世界有色金属
电吸附法在岩石地球化学找矿中的试验及初步效果  ——以内蒙古赤峰金蟾金矿为例	Mineral Resources and Geology
东昆仑巴隆河西金矿地质特征与找矿标志	地质与勘探
东昆仑地区洪水河口金矿地质特征及找矿潜力分析	China’s Manganese Industry
东昆仑五龙沟金矿田地质特征与成矿地质体厘定	Acta Geologica Sinica
东昆仑西段阿其音金矿成矿流体特征及其成因机制	西北地质
东天山马头滩金矿的成矿时代及其地质意义	Geological Bulletin of China
东天山天运金矿的发现及意义	Mineral Exploration
东天山西凤山金矿花岗岩锆石U-Pb年龄、地球化学及其对成岩成矿时代的限定	Mineral Exploration
东天山玉峰金矿热液蚀变作用与元素迁移规律	Acta Petrologica Sinica
动态构建福建紫金山铜金矿矿体模型	吉林大学学报(地科版)
短波红外光谱、X射线荧光光谱、黄铁矿热电性分析在胶东新城金矿田深部找矿中的应用	Earth Science Frontiers
多源遥感技术在青海大场金矿环境预测中的应用	Conservation and Utilization of Mineral Resources
多源遥感数据在西藏念扎金矿地质勘查工作中的应用	Contributions to Geology and Mineral Resources Research
多种物探方法在胶西北金矿集中区深部勘探的效果分析	Geophysical and Geochemical Exploration
鄂东北金鸡坳金矿成矿流体性质及物质来源：来自矿床地质、流体包裹体及S同位素证据	Mineral Exploration
鄂东南地区金井咀金矿早白垩世闪长岩Sr-Nd及锆石Hf同位素研究	中国地质
鄂东南地区铜金矿找矿方向	Mineral Resources and Geology
鄂南泉塘王金矿地质特征及找矿方向探讨	Resources Environment & Engineering
鄂西黄陵背斜核部金矿地球化学特征及成因探讨	Resources Environment & Engineering
分形模型在黑龙江漠河地区金矿成矿预测中的应用	吉林大学学报(地球科学版)
福建德化地区找矿进展及金矿成矿特征	Acta Mineralogica Sinica
福建东际金矿成矿地质条件分析	Mineral Exploration
福建李家坊金矿床磁铁矿成因及其对金矿化过程的指示	矿床地质
福建邱村金矿地质特征及矿床成因	Bulletin of Mineralogy,Petrology and Geochemistry
福建紫金山高硫型铜金矿采矿境界面生态修复技术研究	矿产勘查
富林地区韧性剪切带型岩金矿找矿方法探讨	中文科技期刊数据库(全文版)工程技术
甘南地区金矿找矿标志与找矿模型  ——大水、早子沟、拉尔玛金矿床对比分析	Mineral Resources and Geology
甘南地区三个特大型金矿主矿体及矿石特征对比分析	Geological Review
甘南西部录豆艘金矿地质特征及找矿方向探讨	Mineral Exploration
甘肃北山东小泉金矿地质特征及找矿标志	RESOURCES
甘肃北山南带前红泉金矿的发现及其找矿意义	西北地质
甘肃北山南金山南新发现缓倾厚大隐伏金矿	中国地质
甘肃大店沟金矿床蚀变矿物特征与金矿化的关系	矿产与地质
甘肃大水金矿Au元素的迁移和沉淀方式研究	Acta Mineralogica Sinica
甘肃大水金矿地球化学特征研究进展	FUJIAN ZHILIANG GUANLI
甘肃大水金矿地质特征及矿床成因研究	Acta Mineralogica Sinica
甘肃岗岔金矿黄铁矿热电性及深部金矿化预测	Bulletin of Mineralogy,Petrology and Geochemistry
甘肃岷县寨上金矿成矿年代及矿床成因探讨	Acta Petrologica Sinica
甘肃南部大水金矿集区找矿标志及找矿潜力分析	Geology and Exploration
甘肃南部大水金矿矿集区磁异常特征及找矿分析	Geophysical and Geochemical Exploration
甘肃南金山金矿地质特征及金富集规律分析	Mineral Exploration
甘肃西秦岭地区金矿勘查进展及找矿方向	Mineral Deposits
甘肃西秦岭阳山金矿控矿构造特征及对勉略构造混杂岩带金矿勘查的启示	Geological Bulletin of China
甘肃阳山金矿带安坝矿段地质特征	Geology and Exploration
甘肃阳山金矿带矿床地质特征、控矿因素及找矿标志	Mineral Exploration
甘肃阳山金矿载金黄铁矿硫同位素Nano-SIMS原位分析	Mineral Deposits
甘肃阳山金矿整装勘查区成矿与找矿关键科学问题	Mineral Deposits
甘肃早子沟金矿“三位一体”找矿预测地质模型的构建	Mineral Exploration
甘肃早子沟金矿复合成矿构造系统的构成、样式、演化和控矿规律	Geotectonica et Metallogenia
甘肃早子沟金矿三维建模与综合成矿预测	Acta Geoscientica Sinica
甘肃早子沟特大型金矿详查与勘探两阶段北东向矿带主矿体特征对比分析	Mineral Exploration
甘肃寨上金矿北矿带原生晕分带与深部矿体预测模型	Geological Review
甘肃寨上金矿黄铁矿特征与成因	Acta Mineralogica Sinica
甘肃寨上金矿南矿带构造叠加晕实用模型及深部找矿预测	Geoscience
高Sr低Y埃达克质岩石与金矿成矿关系  ——以陕西省凤县八卦庙金矿为例	Mineral Exploration
高光谱蚀变信息在金矿找矿预测中的应用研究——以北山方山口金矿线索为例	Remote Sensing For Land & Resources
高精度磁测在第四系覆盖地区寻找金矿靶区的应用：以内蒙古查嘎尔崩金矿为例	Contributions to Geology and Mineral Resources Research
高精度磁测在高寒地区金矿普查中的作用	中文科技期刊数据库(全文版)自然科学
高硫砷金矿焙砂的硫酸熟化法预处理	The Chinese Journal of Nonferrous Metals
高频大地电磁测深与激电中梯在金矿勘查中的应用研究	Mineral Exploration
构造地球化学找矿方法在山东沂南金矿的应用及效果	Bulletin of Mineralogy,Petrology and Geochemistry
构造地质在变质岩金矿勘探及采矿中的运用分析	世界有色金属
构造叠加晕在广东河台金矿的应用	Geology and Exploration
构造控制下的蚀变—矿化体的形成 ——以冀西北崇礼中山沟金矿为例	Geological Review
构造-蚀变岩相填图方法在南秦岭汉阴黄龙金矿中的应用	Geology and Exploration
关于汉中西乡李家沟地区金矿找矿方法及成矿规律的研究	中文科技期刊数据库(全文版)自然科学
关于胶西北金矿成矿地球化学机制的思考	Geophysical and Geochemical Exploration
关于金矿地质勘查现状及找矿方向	World Nonferrous Metals
关于金矿地质特征以及成矿规律的研究	中文科技期刊数据库(全文版)工程技术
关于金矿矿床地质特征与矿床成因的探讨	World Nonferrous Metals
关于金矿矿山采矿安全管理问题探析及防护措施	中文科技期刊数据库(文摘版)工程技术
关于金矿中金元素标准测试方法的对比及分析	World Nonferrous Metals
关于深部金矿资源勘查的因素分析及找矿前景	世界有色金属
关于新疆阿克陶县切帕勒克金矿地质特征及控制因素探究	中文科技期刊数据库(全文版)自然科学
关于新疆若羌县亮剑峡金矿地质特征及找矿前景探究	中文科技期刊数据库(全文版)自然科学
官庄—沙坪—带金矿地质特征及找矿预测	Mineral Exploration
广东河台金矿矿物化学特征及其地质意义	Acta Mineralogica Sinica
广东河台整装勘查区百旁金矿成矿规律	Contributions to Geology and Mineral Resources Research
广东省阳春市金塘径金矿的地质特征、找矿标志及下一步找矿方向	中文科技期刊数据库(全文版)自然科学
广西凤山县林老平金矿地球化学特征与找矿	中国矿业
广西贵港新村金矿地球化学特征及深部找矿前景	Mineral Resources and Geology
广西六安金矿地质特征与控矿因素	Mineral Exploration
广西龙胜大地金矿枫木坪矿段矿床地质特征及金的赋存状态	矿产与地质
广西龙头山金矿载金黄铁矿地球化学特征	The Chinese Journal of Nonferrous Metals
广西隆林县德峨地区金矿地质特征及找矿标志	Broad Review Of Scientific Stories
广西平乐县油麻口金矿地质特征及找矿标志分析	中文科技期刊数据库(全文版)自然科学
广西平南县新坪金矿成矿规律及找矿预测	Geoscience
广西平南新坪金矿成矿流体特征及矿床成因初探	Geoscience
广西田林赖屯金矿地质特征及成因探讨	中文科技期刊数据库(全文版)自然科学
广西昭平湾岛金矿矿床类型、成矿时代及其地质意义	Earth Science Frontiers
广域电磁法在胶西北金矿集中区深部探测中的应用研究	Geophysical and Geochemical Exploration
广域电磁法在上宫金矿集区的应用研究	Geophysical and Geochemical Exploration
贵州金矿金的测定方法及空间分布规律	中文科技期刊数据库(引文版)工程技术
贵州烂泥沟金矿三维定量预测	Acta Geoscientica Sinica
贵州泥堡金矿成矿流体特征及其地质意义	Science Technology and Engineering
贵州泥堡卡林型金矿热液蚀变矿物学研究及其地质意义	Mineral Deposits
贵州盘县架底金矿稀土元素和同位素特征及成矿物质来源探讨	Geology and Exploration
贵州晴隆山节地金矿矿体特征及成矿规律	Geological Review
贵州省册亨赖子山背斜南西段金矿找矿战略选区评价	RESOURCES
贵州省卡林型金矿地下水特征研究——以安龙县豹子洞金矿为例	Resources Environment & Engineering
贵州省三都—丹寨地区金矿成矿规律及潜力预测	Acta Mineralogica Sinica
贵州省贞丰县水银洞金矿外围详查	CHINA SCIENCE AND TECHNOLOGY ACHIEVEMENTS
贵州水银洞金矿的几点新认识	Geology and Exploration
贵州万人洞金矿电性特征及金矿找矿规律研究	Geological Survey of China
贵州西部峨眉山玄武岩区金矿赋矿层位及矿石特征研究要要要以盘县架底金矿为例	地质与勘探
贵州西南部SBT与金矿成矿动力学及找矿预测地质模型	Geological Review
贵州兴仁包谷地背斜金矿地球化学特征及其找矿意义分析	China’s Manganese Industry
贵州贞丰水银洞金矿矿床成因与成矿模式:来自载金黄铁矿NanoSIMS多元素Mapping及原位微区硫同位素的证据	Earth Science Frontiers
贵州贞丰县簸箕田Ⅰ金矿水化学与井巷充水特征分析	Mineral Resources and Geology
贵州紫木凼金矿流体包裹体研究	Science Technology and Engineering
桂北刘家岭石英脉型金矿地质特征、矿床成因及找矿前景	矿产与地质
桂北龙胜地区金矿成矿规律及找矿预测	Mineral Resources and Geology
桂北龙胜岩湾金矿稀土元素四分组效应及其地质意义	Contributions to Geology and Mineral Resources Research
桂东北地区煌斑岩与金矿成矿关系探讨	Acta Mineralogica Sinica
桂东大瑶山成矿带鸡笼顶金矿地质特征及找矿前景	Mineral Resources and Geology
桂西百定辉绿岩型金矿地质特征及找矿前景	矿产与地质
桂西北百勇金矿、百蓬金矿粗粒黄铁矿和毒砂的矿物学特征	Acta Mineralogica Sinica
桂西北马雄金矿地质特征及其成因探讨	Acta Mineralogica Sinica
桂西北明山卡林型金矿同位素地球化学特征分析	Acta Mineralogica Sinica
桂西北微细浸染型金矿中铂族元素的发现及其找矿意义	Contributions to Geology and Mineral Resources Research
桂西孤立台地寒武系白云岩中的卡林型金矿床 ——以隆林德峨金矿为例	Mineral Deposits
桂西龙川-世加辉绿岩型金矿的成矿背景研究	Acta Mineralogica Sinica
桂西隆林孤立台地卡林型金矿的“梯式”结构模型及找矿前景	Geotectonica et Metallogenia
桂西马雄金矿微量、稀土元素地球化学特征及其成矿指示意义	矿产与地质
哈达门沟金矿蚀变分带的高光谱分析及找矿意义	自然资源遥感
哈达门沟—柳坝沟金矿田成矿年代研究	Contributions to Geology and Mineral Resources Research
哈图金矿带成矿流体组分、硫同位素分析及矿床成因	Geology and Exploration
海马谷断裂北西盘金矿化蚀变带的发现及地质意义	矿产勘查
海南抱伦矿区构造变形、成矿时代与金矿化关系研究	Geotectonica et Metallogenia
海南东方不磨金矿综合地球化学异常分带模型与找矿预测标志	Mineral Resources and Geology
海下金矿破碎围岩空区治理二次开采稳定性研究	金属矿山
海域金矿找矿方法研究——以山东省莱州市三山岛北部海域金矿为例	Acta Geologica Sinica
含砷金矿微生物预氧化过程强化方法研究进展	Conservation and Utilization of Mineral Resources
含碳金矿选冶理论研究进展及应用现状	现代矿业
河北东坪金矿地质地球化学特征	Geological Review
河北东坪金矿控矿因素及成因探讨	Geological Review
河北丰宁县老米沟门金矿地质特征及控矿因素	Mineral Exploration
河北华尖金矿稳定同位素特征及其地质意义	Bulletin of Mineralogy,Petrology and Geochemistry
河北金厂峪金矿床辉钼矿与金矿化关系研究及意义	Acta Geoscientia Sinica
河北金厂峪金矿红色钠长石脉的成因及地质意义	Geological Review
河北滦平县桥头花岗岩矿及其共生金矿的地质特征	Mineral Exploration
河北茅山金矿含矿地层地球化学特征及物源属性研究	中文科技期刊数据库(全文版)工程技术
河北省赤城县万全寺银金矿形成时代及其地质意义	Acta Geoscientica Sinica
河北省秦皇岛市凤凰山地区金矿成矿地质条件及找矿潜力概述	有色矿冶
河北省石湖金矿含金石英脉中锆石U-Pb年龄及其地质意义	Geological Science and Technology Information
河北省洼子店金矿成矿地质条件、控矿因素及找矿方向	Contributions to Geology and Mineral Resources Research
河北易县栾木厂金矿成因与找矿方向研究	Scientific and Technological Innovation
河北营里金矿地质特征及矿床成因探讨	Mineral Exploration
河北张宣地区中山沟金矿成矿流体特征及其对侵入岩型碲金矿床的限定	Geology in China
河北中山沟金矿含金石英脉中锆石U-Pb年代学及Hf同位素研究	Geological Review
河南大华山金矿地质特征及找矿方向	Mineral Exploration
河南光山县上范洼金矿地质特征与找矿标志研究	China’s Manganese Industry
河南郭家岭金矿原生晕特征及深部找矿预测	Mineral Exploration
河南槐树坪金矿成矿物质共生组合规律及成矿期次	Geophysical and Geochemical Exploration
河南宽坪金矿地质特征及找矿方向	Mineral Exploration
河南老湾金矿床上上河矿段矿床地质和成矿流体地球化学	Mineral Deposits
河南灵宝市小秦岭金矿田流体包裹体特征及地质意义	Mineral Resources and Geology
河南栾川山湾金矿地质特征及找矿远景	Conservation and Utilization of Mineral Resources
河南梅子沟金矿矿床地质特征及矿床成因浅析	Mineral Exploration
河南内乡杏树坪金矿地质特征及成因浅析	China’s Manganese Industry
河南祁雨沟金矿田189号矿床流体包裹体与矿床成因研究	Geotectonica et Metallogenia
河南陕县大方山金矿地质特征及成矿远景	自然科学(全文版)
河南省鲁山县西沟金矿成矿地质条件及找矿设想	Mineral Resources and Geology
河南省洛宁县吉家洼金矿工程地质建模	金属矿山
河南省前河金矿矿床成因及成矿模式探讨	Contributions to Geology and Mineral Resources Research
河南省陕县张家河金矿地质特征及找矿标志	Mineral Exploration
河南省上宫金矿矿床成因及控矿因素研究	能源与环保
河南省嵩县前河金矿北部一带矿床特征、成因及找矿标志	Mineral Resources and Geology
河南省桐柏上上河金矿带断裂控矿体系及地质意义	Mineral Resources and Geology
河南省西峡县高庄金矿Rb-Sr等时线年龄和H、O、S、Pb同位素特征：北秦岭板内造山成矿作用的识别	Geology in China
河南省西峡县水地沟金矿地质特征及S、Pb同位素示踪	Geology and Exploration
河南嵩县画匠沟金矿化区土壤地球化学异常特征及成矿预测	矿产与地质
河南嵩县庙岭金矿矿体赋存规律及深部找矿预测	地质通报
河南嵩县前河金矿地质特征及找矿标志	自然科学(全文版)
河南嵩县沙土凹金矿矿床成因分析	Resource Information and Engineering
河南桐柏上上河金矿地质特征及综合成矿模型	矿产与地质
河南熊耳山东草沟金矿石英流体包裹体研究	南方金属
河南熊耳山干树金矿成矿作用与围岩蚀变特征	Contributions to Geology and Mineral Resources Research
河南秧城一带金矿预查区土壤地球化学测量样品采样层位、加工粒级对比研究	Mineral Resources and Geology
河南银洞坡金矿成矿流体与矿床成因研究	Geoscience
河南镇平县祈子堂金矿地质特征及矿床成因分析	矿产与地质
河西金矿中等稳固矿体开采方法研究	现代矿业
黑龙江东安-汤旺河地区中生代岩浆作用有关钼铁金矿找矿方向	Geology and Exploration
黑龙江黑河争光金矿异常结构模式研究	Geology and Exploration
黑龙江三道关林场金矿成矿地质特征及找矿方向分析	Scientific and Technological Innovation
黑龙江三道湾子金矿Au-Ag-Te系列矿物特征及其成矿阶段分析	Geology and Exploration
黑龙江省东安-汤旺河金矿整装勘查区矿床地质特征、找矿标志及成矿远景区划?	Geological Review
黑龙江省东宁县五道沟金矿成矿流体特征及矿床成因	Geoscience
黑龙江省黑河市争光金矿流体包裹体研究及矿床成因	Acta Petrologica Sinica
黑龙江省嫩江—黑河构造混杂岩区永新金矿热液蚀变与矿化关系定量及定位研究	Geoscience
黑龙江省嫩江三合屯韧性剪切带与金矿化	Mineral Resources and Geology
黑龙江乌拉嘎金矿成矿热力学参数研究	Acta Petrologica Et Mineralogica
黑龙江争光大型金矿成矿流体He-Ar-S同位素组成及成矿流体来源的示踪	中国地质
黑龙江争光金矿地质特征与年代学特征及意义	地质学报
黑龙江争光金矿水文地质特征浅析	Contributions to Geology and Mineral Resources Research
后龙门山北东段辛家咀地区新发现一脆-韧性剪切带型金矿	中国地质
湖北保康六冲坪金矿流体包裹体特征及成矿机理探讨	Resources Environment & Engineering
湖北大悟大磊山金矿矿床成因与控矿构造	Acta Petrologica Et Mineralogica
湖北嘉鱼蛇屋山红土型金矿研究回顾与展望	Geological Review
湖北嘉鱼蛇屋山金矿地球物理特征及找矿方向	Resources Environment & Engineering
湖北龙兴沟地区花岗斑岩地质特征及其与金矿成矿关系	Resources Environment & Engineering
湖北省蛇屋山金矿地质特征、控矿因素及成矿机制探讨	Resources Environment & Engineering
湖北随县黑龙潭金矿稳定同位素特征及其地质意义	Resources Environment & Engineering
湖北随州黑龙潭金矿石英Rb-Sr同位素年龄及其地质意义	Geological Bulletin of China
湖北雾渡河断裂带金矿地球化学特征及成因探讨  ——以姜家沟金矿为例	Resources Environment & Engineering
湖北宜昌白竹坪金矿流体包裹体特征及成矿机理探讨	Resources Environment & Engineering
湖南半边山金矿成矿地质条件与找矿前景分析	Mineral Exploration
湖南常宁仙人岩金矿找矿过程及实物地质资料再利用	Geological Bulletin of China
湖南大叶塘金矿流体包裹体研究和成因探讨	Mineral Exploration
湖南洪江市石榴寨金矿流体包裹体特征及地质意义	Mineral Resources and Geology
湖南浏阳—醴陵官庄地区金矿地质特征及控矿因素分析	Mineral Resources and Geology
湖南省包金山金矿流体包裹体特征	Acta Mineralogica Sinica
湖南省平江县万古矿区江东金矿地质特征及找矿方向探讨	Resource Information and Engineering
湖南省五强溪金矿田东矿区金矿地质特征与成矿机理研究	Resource Information and Engineering
湖南双峰县包金山金矿成矿流体与矿床成因	中国有色金属学报
湖南水口山矿田金矿控矿因素、成矿演化及成矿预测	矿产与地质
湖南沃溪金锑钨矿床的金矿化作用研究：基于元素地球化学特征和自然金的热力学模拟分析	地质学报
华北克拉通北缘柴胡栏子金矿富甲烷流体包裹体的发现及地质意义	Acta Geologica Sinica
华北克拉通金矿综合地球物理探测研究进展——以辽东地区为例	Scientia Sinica(Terrae)
华北陆块晋冀成矿带十八盘金矿地质特征与找矿标志研究	能源与环保
华南加里东期造山型金矿中金的来源—来自浙江诸暨陈蔡杂岩的证据	Geology and Exploration
化探技术之成矿指示元素组合研究——以豫西牛头沟金矿为例	Geology and Exploration
化探数据挖掘在金矿找矿及靶区优选中的应用  ——以甘肃玉石山地区为例	Acta Petrologica Sinica
化学分析在白山市板庙子金矿研究中的应用	Scientific and Technological Innovation
基底构造对矿床定位的控制机制：焦家金矿带构造应力转移模拟	Acta Petrologica Sinica
基性岩地球化学特征及其与金矿的关系——以云南富宁者桑金矿为例	Advances in Geosciences
基于3D Mine的阳山金矿安坝矿段三维建模研究及矿体形态分析	Geology and Exploration
基于ASTER的康古尔塔格金矿带热液矿化蚀变信息提取	Contributions to Geology and Mineral Resources Research
基于GIS技术的黔西南地区金矿找矿远景预测	Contributions to Geology and Mineral Resources Research
基于MRAS证据权重法的湖南怀化地区金矿成矿预测	Geophysical and Geochemical Exploration
基于MRAS证据权重模型的河南老湾地区金矿成矿预测	Geophysical and Geochemical Exploration
基于Surpac的内蒙古哈达门沟金矿三维数字建模	现代矿业
基于成矿流体包裹体的勘探  ——以柴北缘鱼卡造山型金矿为例	Contributions to Geology and Mineral Resources Research
基于地质统计学的吉尔吉斯斯坦库鲁铜金矿三维地质建模	Contributions to Geology and Mineral Resources Research
基于高光谱数据的甘肃花西山金矿蚀变特征分析与找矿预测应用	地质与勘探
基于构造叠加晕方法的内蒙古金厂沟梁金矿36号脉深部矿体预测	Contributions to Geology and Mineral Resources Research
基于机器学习的主成分分析方法在金矿类型判别中的应用:以黄铁矿元素地球化学特征为例	岩石学报
基于激光扫描技术的金矿矿脉三维建模与测量研究	中国科技期刊数据库 工业A
基于金矿规格单元数据的机器学习方法在成矿建模分析中的应用	Geotectonica et Metallogenia
基于卷积神经网络和黄铁矿大数据判别金矿类型	地质学报
基于科学钻探技术的老湾金矿带金成矿机制研究	金属矿山
基于三维建模的金矿带成矿预测技术研究	能源与环保
基于三维矿化域数字模型对澳大利亚Camel 1金矿找矿预测研究	Geology and Exploration
基于声发射试验与线弹性能判据的玲南金矿岩爆研究	Chinese Journal of Rock Mechanics and Engineering
基于烃类组分结构的海域金矿成矿带演化特征	Mineral Resources and Geology
基于遥感信息提取技术的泰国铜金矿成矿预测	Geological Bulletin of China
基于证据权-奇异性-灰色理论的山西五台地区金矿成矿研究	Geological Bulletin of China
基于资源一号02D卫星高光谱数据的甘肃头吊泉-南大滩地区蚀变矿物填图及金矿化带识别	Geology and Exploration
激电测量在甘肃省徽县刘家沟铜金矿上的应用	World Nonferrous Metals
激电测深法在南沙河金矿勘查中的应用	World Nonferrous Metals
激电法在巢湖市山里许矽卡岩型铜金矿靶区评价中的应用	Geological Survey of China
激电中梯测量在金矿普查中的应用	中国金属通报
激电中梯和激电测深在石英脉型金矿勘查中的应用研究	Mineral Resources and Geology
激电中梯剖面测量在青海大格勒沟脑地区金矿勘查中的应用	China Molybdenum Industry
激发极化法在深部金矿勘查中的应用	中国金属通报
吉林百草沟金矿闪长玢岩锆石UPb年代学、地球化学及其地质意义	Mineral Deposits
吉林夹皮沟金矿集区三道岔金矿床成矿流体来源与演化——流体包裹体和H-O同位素的制约	吉林大学学报(地球科学版)
冀东唐杖子金矿:一个典型的隐爆角砾岩型金矿	Geology and Exploration
冀东下营坊金矿成矿年代学研究	Geology and Exploration
剪切带型金矿中金沉淀的力化学过程与成矿机理探讨	Acta Petrologica Sinica
剪切应变异常带近等距控矿模式——以粤西河台金矿为例	Geology and Exploration
江南造山带(湖南段)金矿成矿规律与资源潜力	Acta Geoscientica Sinica
江苏仑山金矿地质特征与矿床成因探讨	Mineral Exploration
江西槽坑银金矿地质特征及找矿方向	中文科技期刊数据库(全文版)自然科学
江西大坪金矿成矿特征及找矿方向	Mineral Resources and Geology
江西金山矿田罗家墩金矿地球化学、锆石U-Pb年龄及地质意义	Mineral Exploration
江西南城蔡田金矿成矿规律研究	Mineral Exploration
江西弋阳刘家金矿矿床地质特征及成因	Geological Review
蒋家山沟金矿综合物、化探的找矿效果	Geophysical and Geochemical Exploration
胶东北部大柳行金矿田成矿构造的广域电磁法勘查及对深部找矿的指示	Geological Bulletin of China
胶东大柳行金矿田庵口金矿床成矿流体与成矿物质来源	矿床地质
胶东大尹格庄金矿碳酸盐矿物的特征、物源及其在金成矿过程中的作用	岩石学报
胶东地区郭城金矿地质特征及成因探讨	Mineral Deposits
胶东地区玲珑金矿田东风矿床Rb-Sr同位素年龄及其地质意义	Geological Review
胶东地区新立金矿中金矿物和载金黄铁矿成因矿物学特征及地质意义	岩矿测试
胶东地区招贤深部金矿床金和载金矿物化学成分及其地质意义	Mineral Deposits
胶东邓格庄金矿成矿流体、成矿物质来源与矿床成因	Acta Petrologica Sinica
胶东金翅岭金矿成矿流体特征及地质意义	The Chinese Journal of Nonferrous Metals
胶东金矿成矿深度的构造校正测算及成矿预测	Earth Science Frontiers
胶东金矿成矿时代及区域地壳演化——基性脉岩的SHRIMP锆石U-Pb年龄及其地质意义	Geological Bulletin of China
胶东金矿硫同位素组成特征及其来源	Geological Bulletin of China
胶东金矿陆内构造岩浆核杂岩隆起-拆离带蚀变成矿	Earth Science Frontiers
胶东金矿三维地质建模技术研究	Surveying and Mapping of Geology and Mineral Resources
胶东金矿深部找矿主要成果和关键理论技术进展	Geological Bulletin of China
胶东金矿与中生代区域性花岗岩关系及成矿预测和找矿方向	山东国土资源
胶东玲珑金矿黄铁矿的化学成分标型特征及其矿床学意义	Contributions to Geology and Mineral Resources Research
胶东玲珑金矿田不同矿段构造变形岩相带特征与深部找矿预测	Geological Bulletin of China
胶东玲珑金矿田成矿特征和成矿作用	地质学报
胶东玲珑金矿田构造蚀变岩测量与成矿预测	Earth Science Frontiers
胶东玲珑金矿田金的赋存状态及其对成矿过程的指示意义	岩石学报
胶东牟平-乳山成矿带金青顶金矿广域电磁法探测效果分析	Geology and Exploration
胶东蓬莱大柳行金矿田燕山金矿床流体包裹体特征和氢-氧同位素研究	Acta Geologica Sinica
胶东蓬莱-栖霞金矿带侯格庄金矿流体包裹体特征及其地质意义	山东国土资源
胶东栖霞大霞址断裂南段金矿地质特征及成因研究	山东国土资源
胶东栖霞金矿集区早白垩世花岗岩形成时代及地质意义	Geotectonica et Metallogenia
胶东栖霞山城金矿流体包裹体特征及其成矿意义	山东国土资源
胶东三山岛北部海域金矿蚀变特征与微量元素迁移规律	西北地质
胶东三山岛断裂构造蚀变岩三维控矿规律研究与海域超大型金矿的发现	Earth Science Frontiers
胶东三山岛金矿构造控矿规律研究	Geotectonica et Metallogenia
胶东山后金矿成矿流体及成矿物质来源：来自H-O、Sr-Nd-Pb、He-Ar同位素证据	山东国土资源
胶东山后金矿流体包裹体及H-O-S同位素特征	Geological Science and Technology Information
胶东深部金矿三维成矿预测及巨大的资源潜力	金属矿山
胶东蚀变岩型金矿金矿物微区地球化学特征	Acta Petrologica Sinica
胶东寺庄金矿热液蚀变作用与元素迁移规律	Bulletin of Mineralogy Petrology and Geochemistry
胶东谢家沟金矿热液蚀变作用过程的元素迁移规律	Geological Bulletin of China
胶东新类型金矿——辽上黄铁矿碳酸盐脉型金矿	Acta Geoscientica Sinica
胶东型金矿:与壳源重熔层状花岗岩和壳幔混合花岗闪长岩有关的金矿	Acta Geologica Sinica
胶东型金矿热隆-伸展成矿系统	岩石学报
胶东燕山期大型-超大型金矿集区形成的壳幔结构探讨:来自致矿火成岩(组合)的约束	Earth Science Frontiers
胶东招平金矿带水旺庄矿区金矿深部预测	Mineral Deposits
胶东中生代花岗岩与金矿关系及成矿期划分	地质学报
胶东主要金矿类型流体包裹体特征对比及其对成矿环境差异的指示——以纱岭、旧店和辽上金矿床为例	地质通报
胶莱盆地东北缘地区金矿特征及找矿方向	Geology and Exploration
胶莱盆地东北缘西涝口金矿煌斑岩脉岩石地球化学、锆石U-Pb年龄及其对构造岩浆事件的记录	Geological Bulletin of China
胶莱盆地郭城-崖子断裂带金矿集区剥蚀程度及深部找矿潜力	中国有色金属学报
胶西北大尹格庄金矿岩石化学与成矿作用	The Chinese Journal of Nonferrous Metals
胶西北地区谢家沟金矿岩脉U-Pb年龄及其对成矿时限的制约	Geological Bulletin of China
胶西北河东金矿多元异常信息找矿预测	Earth Science Frontiers
胶西北焦家断裂带成矿后断裂活动对焦家式金矿破坏作用及找矿方向探讨	Geological Review
胶西北焦家金矿深部成矿流体性质及成矿作用	Geological Review
胶西北焦家式金矿控矿构造蚀变带的地球化学标志	Earth Science Frontiers
胶西北金矿构造控矿规律定量分析	地质学刊
胶西北金矿集区基于超壳走滑断裂构造体系的金成矿机制探讨 ——来自深反射地震探测的证据	山东国土资源
胶西北金矿集区深部成矿构造三维建模与找矿意义	Acta Geoscientica Sinica
胶西北金矿阶梯式成矿模式的探讨	中文科技期刊数据库(全文版)工程技术
胶西北金矿控矿断裂深部特征及对找矿的启示——来自地球物理探测的证据	中国地质
胶西北玲珑、焦家金矿田锆石(U-Th)/He年龄及其对成矿后剥露程度的指示	Earth Science
胶西北夏甸金矿控矿地质因素分析与深部找矿预测	Contributions to Geology and Mineral Resources Research
胶西北招平断裂带南段金矿勘查模型及找矿方向	Geology and Exploration
焦家金矿成矿流体垂向变化特征及对胶东金成矿过程的启示	Bulletin of Mineralogy, Petrology and Geochemistry
焦家金矿田构造蚀变岩填图及其地球化学特征分析	Earth Science Frontiers
焦家金矿田矿床地质特点分析及成矿规律	中文科技期刊数据库(全文版)自然科学
金矿中金元素标准测试方法对比及分析	World Nonferrous Metals
金盆金矿矿床地质特征及找矿方向探讨	Resource Information and Engineering
金属元素形成原生晕能力定量评价  ——以青海省扎家同哪金矿为例	Geophysical and Geochemical Exploration
金亭岭金矿与萑香洼金矿矿床地球化学异常模型差异性初探	China’s Manganese Industry
金牙微细浸染型金矿地质特征及其控矿因素研究	Advances in Geosciences
巨型矿床形成与定位的构造控制: 胶东金矿集区剖析	Geotectonica et Metallogenia
卡林型金矿的成矿流体来源研究取得新进展	Bulletin of Mineralogy,Petrology and Geochemistry
康定大渡河金矿田稀土元素地球化学特征研究	Chinese Rare Earths
克拉通破坏型金矿成矿机制：吉南板庙子金矿床闪长玢岩与重晶石流体包裹体、H-O-S同位素证据	Acta Petrologica Sinica
老鸦岔金矿矿区地质特征及矿床开采技术条件研究	能源与环保
类中梯装置的大功率三维激电法在甘肃花牛山金矿勘查中的应用	地质与勘探
连续电导率观测系统在五龙金矿深部找矿预测中的应用研究	Geology and Exploration
辽东半岛五龙金矿成矿系统新认识：来自外围热液角砾岩型铅锌矿化的指示	Acta Petrologica Sinica
辽东大东沟金矿岩浆岩LA-ICP-MS锆石U-Pb年龄及岩石地球化学特征	Geological Bulletin of China
辽东地区王家崴子金矿古元古代金预富集矿化事件	岩石学报
辽东裂谷白云金矿载金黄铁矿Re-Os定年及其地质意义	Geotectonica et Metallogenia
辽东三股流岩体是否为五龙金矿成矿提供必要的能量？	Earth Science
辽东五龙.四道沟金矿集区花岗杂岩SHRIMP U-Pb年龄、地球化学特征及地质意义	Geotectonica et Metallogenia
辽东五龙金矿周缘早白垩世花岗岩体侵位深度及其地质意义	Earth Science
辽宁二道沟金矿构造叠加晕特征及深部找矿预测	Geoscience
辽宁黄土岭地区金矿地质特征及找矿方向	Mineral Exploration
辽宁金家金矿元素地球化学特征研究	Mineral Exploration
辽宁省本溪县刘家金矿地质特征及找矿方向探讨	Mineral Exploration
辽宁省金矿成矿规律及成矿系列	Geological Survey of China
辽宁省金矿周边表层土壤重金属超标特征与矿床成因之间的关系	Advances in Geosciences
辽宁省清原县上甸子地区金矿成矿地质特征分析	中文科技期刊数据库(全文版)工程技术
辽宁省重点金矿集区地质特征及成岩成矿作用	中国地质调查
辽宁五龙金矿构造叠加晕研究	Geology and Exploration
辽宁西平地区金矿矿区水文地质条件特征	中文科技期刊数据库(全文版)自然科学
辽宁杨家堡金矿矿床成因和找矿标志分析	现代矿业
辽宁赵家沟金矿地质特征及找矿标志	Mineral Exploration
辽西赤峰—朝阳金矿带早白垩世以来的隆升剥蚀及启示意义	Earth Science Frontiers
辽西二道沟金矿成矿物质来源：来自S-Pb同位素的证据	Geoscience
辽西建平烧锅营子金矿花岗岩的锆石U-Pb年代学、地球化学特征及地质意义	Geology in China
辽西新太古代片麻岩金矿中金与伴生元素的多重分形模型剖析	矿产与地质
灵宝市银家沟硫铁矿共(伴)生金矿资源成矿规律研究	中国资源综合利用
玲珑金矿大开头矿区Bi特征及指示意义	Geophysical and Geochemical Exploration
玲珑金矿深部地应力测量及矿区地应力场分布规律	CHINESE JOURNAL OF ROCK MECHANICS AND ENGINEERING
玲珑金矿田深部断裂蚀变岩相分带特征研究	Geological Review
玲珑金矿田深部找矿预测与找矿理论实践	Geological Review
龙门山构造带金矿成矿潜力探讨	Acta Mineralogica Sinica
楼房沟金矿地质特征及找矿标志	CHINA SCIENCE AND TECHNOLOGY ACHIEVEMENTS
鲁西地区绿岩带型金矿成矿期次及其矿源讨论	Advances in Geosciences
鲁西归来庄金矿断裂构造控矿规律研究	西北地质
鲁西归来庄金矿田碲金元素地球化学过程研究	Mineral Deposits
鲁西铜石大平安庄地区金矿找矿预测	Mineral Exploration
鲁西铜石地区金矿成矿综合信息预测	Contributions to Geology and Mineral Resources Research
鲁西夏家小河构造蚀变型金矿地质特征及找矿标志	Resource Information and Engineering
鲁西中生代金矿形成时代、物质来源及问题讨论	Acta Geologica Sinica
露天金矿边坡稳态数值分析及开采深度优化	金属矿山
露天金矿开采安全管理问题探析及防护措施	Science & Technology Industry Parks
论金矿地质找矿勘查技术的趋势与发展	中文科技期刊数据库(全文版)工程技术
论山东胶东金矿形成的挤压‒伸展构造环境	Geotectonica et Metallogenia
论新疆金矿勘探开发的前景	中文科技期刊数据库(文摘版)工程技术
洛大金矿地质特征与找矿标志研究	有色金属设计
绿色催开“效益花”——洛宁吉家洼金矿创建省级绿色矿山小记	资源导刊
绿中求“金” ——洛阳坤宇矿业有限公司上宫金矿绿色矿山建设纪实	资源导刊
脉岩特征与金矿化关系浅析―以辽宁台吉营子金矿1号矿体为例	Geological Review
脉岩在蓬莱东南区金矿探矿中的应用思路探讨	China Metal Bulletin
幔枝构造对小秦岭金矿成矿作用的控制	矿产勘查
那都金矿资源勘探与开采研究	Resource Information and Engineering
南岭地区与金矿有关岩浆岩成矿专属性初探	Geotectonica et Metallogenia
南秦岭东沟—金龙山金矿地质特征、成矿时代及其地质意义	Earth Science Frontiers
南秦岭东江口岩体中丰富金矿矿床特征与成因浅析	Geology and Exploration
南秦岭汉阴北部金矿田脆—韧性剪切带控矿特征及构造变形—成矿年代学研究	Geotectonica et Metallogenia
南秦岭汉阴北部长沟金矿三维模型的建立与应用	Geological Review
南秦岭汉阴北部长沟金矿同位素地球化学特征	Geological Review
南秦岭汉阴金矿田长沟金矿陆内造山期构造-蚀变岩相填图与找矿模型	Geological Bulletin of China
南秦岭石泉-汉阴北部煌斑岩脉特征及与金矿化的关系	Geological Review
南秦岭石泉-汉阴金矿带控矿构造特征与矿床成因探讨	Acta Petrologica Sinica
内蒙古阿拉善右旗青德木金矿地质特征及成矿条件浅析	China Metal Bulletin
内蒙古安家营子金矿流体包裹体及氢氧硫同位素研究	Mineral Resources and Geology
内蒙古敖汉旗岱王山金矿田地质特征和资源潜力预测	Geology and Exploration
内蒙古敖汉旗金厂沟梁金矿田成因类型及找矿标志	China Metal Bulletin
内蒙古敖汉旗七家金矿闪长玢岩锆石U-Pb年代学、地球化学及地质意义	Chinese Journal of Geology
内蒙古熬汉旗岱王山金矿的地质特征与控矿因素	Geological Review
内蒙古巴彦哈尔敖包—昌特敖包地区金矿勘查新进展及找矿潜力分析	Mineral Exploration
内蒙古白梁东铜金矿地质特征及找矿前景	Mineral Exploration
内蒙古白音敖包地区金矿成矿特征及成矿系统演化	Geotectonica et Metallogenia
内蒙古包尔敖包地区金矿地质特征及找矿潜力评价	Mineral Exploration
内蒙古包头市哈达门沟金矿地球物理综合方法找矿实例分析	矿产与地质
内蒙古毕力赫斑岩型金矿成矿岩体地球化学、锆石U-Pb年代学及Hf同位素研究	Earth Science Frontiers
内蒙古毕力赫金矿—一种特殊类型的金矿?	Acta Mineralogica Sinica
内蒙古查干础鲁金矿地质特征及其金的产出特征	Geology and Exploration
内蒙古察哈尔右翼中旗大清河金矿地质特征及成因探讨	山东国土资源
内蒙古赤峰柴胡栏子金矿及周边地区构造形迹的“米字型”分布及其控矿特征	Geoscience
内蒙古赤峰金蟾山金矿深部与外围预测	Geological Review
内蒙古赤峰山湾子金矿流体包裹体和年代学研究	Geology in China
内蒙古额济纳旗辉森乌拉金矿地质特征及找矿标志	Mineral Exploration
内蒙古哈达门沟地区金矿地质特征与找矿方向	Mineral Exploration
内蒙古哈达门沟金矿成矿流体来源的氦、氩同位素示踪	Mineral Deposits
内蒙古哈达门沟金矿构造演化及成矿控矿构造特征	Earth Science Frontiers
内蒙古哈腾图雅金矿地质特征及找矿标志	Mineral Exploration
内蒙古浩尧尔忽洞金矿三维建模与深部成矿预测	Earth Science Frontiers
内蒙古黄花窝铺一带金矿地球化学特征及构造控矿分析	中文科技期刊数据库(全文版)自然科学
内蒙古甲浪沟金矿水文地质、工程地质及环境地质调查研究	Mineral Exploration
内蒙古喀喇沁旗安家营子金矿蚀变及其分布研究	Geology and Exploration
内蒙古特拜金矿流体包裹体特征与成矿作用	Geology and Exploration
内蒙古乌拉特中旗图古日格金矿辉钼矿Re-Os同位素年龄及其意义	Geology in China
内蒙古闫家村金矿地质特征及找矿远景预测	Mineral Exploration
内蒙古自治区大型金矿地球化学标志与预测	Acta Geoscientia Sinica
庞西垌-金山银金矿田控矿因素分析	Acta Mineralogica Sinica
彭泽县利山金矿矿体分布特征及矿石加工技术性能研究	中文科技期刊数据库(全文版)自然科学
蓬莱虎路线金矿地质特征及矿床成因	China Metal Bulletin
蓬莱市大柳行地区金矿热液成矿规律及地质勘查工作浅析	China Metal Bulletin
平江县万古矿区边深部金矿地质特征及找矿标志分析	China Metal Bulletin
黔东南地区平秋金矿地质特征及其成矿年龄研究	Mineral Resources and Geology
黔东南地区平秋金矿构造控矿规律及成矿预测	Contributions to Geology and Mineral Resources Research
黔东南金矿与圈定的黔湘桂新元古代火山构造特征及地质意义	Geoscience
黔东南平秋金矿成矿流体特征及其演化过程	矿产与地质
黔东南平秋金矿成因研究：来自氢、氧、硫同位素的制约	Bulletin of Mineralogy,Petrology and Geochemistry
黔东南浅变质碎屑岩中金矿属于造山型金矿的证据	Geological Science and Technology Information
黔西南册亨百地金矿找矿模式初探	Mineral Resources and Geology
黔西南大丫口地区金矿找矿标志及找矿预测研究	Geological Review
黔西南戈塘—海子地区金矿控矿因素分析与成矿模式探讨	矿产与地质
黔西南戈塘金矿成因再认识	Contributions to Geology and Mineral Resources Research
黔西南灰家堡金矿田成矿构造模式及构造地球化学研究	Geotectonica et Metallogenia
黔西南灰家堡金矿田电性结构特征及物探找矿标志研究	Chinese Journal of Engineering Geophysics
黔西南灰家堡金矿田热液方解石稀土元素与C-O-Sr同位素地球化学特征	Bulletin of Mineralogy,Petrology and Geochemistry
黔西南卡林型金矿矿田控矿构造类型及成矿流体特征	Acta Petrologica Sinica
黔西南烂泥沟金矿田构造变形及演化分析	Geological Review
黔西南泥堡—包谷地卡林型金矿田热液矿物地球化学特征及其地质意义	Geological Review
黔西南泥堡金矿矿物学和地球化学初探	Acta Mineralogica Sinica
黔西南泥堡金矿围岩与矿石的对比及其成矿机制研究	Acta Petrologica Sinica
黔西南水银洞超大型金矿龙潭组赋矿层岩相特征及对金成矿的控制	Geological Bulletin of China
黔西南水银洞卡林型金矿构造地球化学及对隐伏矿找矿的指示	Acta Geoscientia Sinica
黔西南微细浸染型金矿的黄铁矿矿物学研究及其成因意义:以水银洞金矿为例	岩石学报
黔西南丫他金矿矿化过程中元素迁移特征研究	Sedimentary Geology and Tethyan Geology
黔西南贞丰水银洞基性岩锆石U-Pb测年及金矿成矿	Science Technology and Engineering
钦杭成矿带皖南天井山金矿研究进展	Acta Mineralogica Sinica
钦杭带南段庞西垌_金山银金矿田控矿构造分析及找矿指示	Mineral Deposits
秦岭地区大桥金矿金的赋存状态及难选性因素探讨	矿产综合利用
秦岭凤太矿集区铅锌金矿区域成矿规律研究	Mineral Resources and Geology
秦岭凤太铅锌-金矿集区成矿规律与找矿预测	Journal of Earth Sciences and Environment
韧性剪切带型金矿三阶段构造成矿模式——以广东河台金矿床为例	Geotectonica et Metallogenia
韧性剪切带型金矿研究进展	Mineral Exploration
三山岛金矿“金色海浪”志愿者服务模式的探索与实践	Science & Technology Industry Parks
三维成矿预测与预测评价——以东昆仑成矿带红旗沟—深水潭金矿为例	Geoscience
三维地质建模及可视化在危机矿山找矿中的应用研究  ——以沂南金矿为例	World Nonferrous Metals
山东大柳行地区金矿地质评价预测及优选	Mineral Exploration
山东胶东地区金矿成矿时代研究	黄金科学技术
山东焦家金矿地质地球化学模型及深部找矿预测评价	Mineral Resources and Geology
山东金翅岭金矿成矿构造及应力场研究	Geology and Prospecting
山东金翅岭金矿蚀变特征与元素迁移规律	Geoscience
山东金岭金岚沟金矿流体包裹体特征	Acta Mineralogica Sinica
山东金亭岭金矿构造系统及其控矿作用	China Metal Bulletin
山东莱州曲家金矿黄铁矿微量元素对成矿过程的指示	岩石矿物学杂志
山东莱州曲家金矿原生晕地球化学分带性研究及地质意义	Acta Geoscientica Sinica
山东莱州曲家矿区金矿成矿背景、矿体特征与资源储量估算	China Metal Bulletin
山东玲珑金矿50号脉三维构造蚀变岩地球化学特征及深部预测	Geological Bulletin of China
山东蓬莱石家金矿原生晕地球化学特征及深部找矿预测	Geoscience
山东平度大庄子金矿构造岩相解析与空白区找矿突破	Earth Science Frontiers
山东平邑地区金矿矿床成因及成矿规律研究	中文科技期刊数据库(全文版)自然科学
山东栖霞笏山-西陡崖金矿地质特征及资源潜力分析	山东国土资源
山东纱岭金矿流体包裹体及氢氧硫同位素特征	Science Technology and Engineering
山东省归来庄金矿田卓家庄含碲金矿床的碲化物赋存状态研究	Mineral Deposits
山东省玲珑金矿田深部成矿规律研究及其应用	Geological Review
山东省栖霞市郭落山金矿矿床地质特征及成因研究	China's Manganese Industry
山东省乳山市于家圈金矿地质特征及找矿前景探讨	山东国土资源
山东省烟台市牟平区黄帽顶地区金矿研究与探讨	中文科技期刊数据库(全文版)工程技术
山东省沂南县铜井地区铜金矿深部地质特征及成矿模式探讨	Contributions to Geology and Mineral Resources Research
山东十里堡地区地质特征及金矿找矿方向	Technology Innovation and Application
山东下潘格庄矿区金矿成矿地质特征及成因浅析	矿山工程
山东沂南金矿田成矿构造系统和构造控矿规律	Geotectonica et Metallogenia
山东招远大尹格庄金矿控矿构造解析与找矿预测	Geology in China
山东招远河东金矿成矿地质条件浅析	自然科学(全文版)
山西梨园金矿黄铁矿微量元素及S-Pb-He-Ar同位素地球化学特征及其地质意义	Earth Science Frontiers
山西灵丘县梨园金矿流体包裹体特征及成矿作用	The Chinese Journal of Nonferrous Metals
山西省繁峙县后峪铜钼金矿锆石形态标型特征	Acta Mineralogica Sinica
山西省柳林县尖家沟一带金矿找矿思路浅析	China Metal Bulletin
山西五台山东腰庄金矿绿泥石成因矿物学研究	Acta Mineralogica Sinica
山西义兴寨金矿田成矿机理研究：来自同位素和流体包裹体的证据	The Chinese Journal of Nonferrous Metals
陕川丁家林-太阳坪-董家院金矿带的矿田构造-岩相学研究	Geotectonica et Metallogenia
陕南汉阴县黄龙金矿脆-韧性剪切带控矿特征研究	Geological Review
陕南煎茶岭金矿成矿地质背景与找矿潜力探讨	中文科技期刊数据库(全文版)工程技术
陕西安康早阳金矿构造控矿规律及找矿标志研究	Geological Review
陕西八卦庙金矿主要成因观点概述	Geological Review
陕西丁家山金矿围岩蚀变特征及其与金矿化的关系	Mineral Exploration
陕西凤太矿集区典型金矿地质特征及其成矿规律	Geological Survey of China
陕西凤县庞家河金矿控矿因素分析及成因研究	Acta Mineralogica Sinica
陕西汉阴-石泉地区下志留统黑色岩系金矿控矿构造规律研究	Mineral Exploration
陕西汉阴县黄龙金矿成矿物质来源及成矿模式探讨	Mineral Exploration
陕西铧厂沟金矿南矿带构造叠加晕特征及深部找矿方向	Geoscience
陕西金矿成矿规律与找矿靶区圈定	西北地质
陕西洛南县水草坪金矿成矿地质特征及找矿远景评价	China Metal Bulletin
陕西略阳张家山金矿成矿作用及Au-Se矿物形成物理化学条件研究	Mineral Deposits
陕西梅子铺金矿地质特征及矿床成因分析	矿产与地质
陕西宁强铜厂湾金矿构造控矿作用探析	中文科技期刊数据库(全文版)自然科学
陕西庞家河金矿地质特征、找矿标志、外围找矿简单分析	China Metal Bulletin
陕西秋树坪金矿似斑状奥长花岗岩脉锆石U-Pb年龄、地球化学特征及地质意义	Mineralogy and Petrology
陕西山阳庙梁金矿地质特征及流体包裹体研究	Acta Petrologica et Mineralogica
陕西省安康市米家沟地区金矿地质特征及成矿潜力浅析	有色矿冶
陕西省凤县铅锌金矿地质特征与勘查方法研究	中文科技期刊数据库(全文版)自然科学
陕西省凤县唐家湾地区金矿地质特征及成矿条件探析	中文科技期刊数据库(全文版)自然科学
陕西省汉阴县黄龙金矿地质特征	China Metal Bulletin
陕西省华县任家滩金矿地质特征及成因浅析	China Metal Bulletin
陕西省煎茶岭金矿C、H、O、S、Pb同位素地球化学示踪	Geotectonica et Metallogenia
陕西省洛南县许家台金矿地质特征及成因探析	中文科技期刊数据库(全文版)自然科学
陕西省宁陕县东沟金矿标型矿物中黄铁矿特征	Technology Innovation and Application
陕西省庞家河金矿黄铁矿标型特征及对深部找矿的启示	中国地质
陕西省山阳县王家坪金矿成因探讨	Acta Mineralogica Sinica
陕西省石泉县梅子乡金矿地质特征探究	中文科技期刊数据库(全文版)工程技术
陕西省旬阳县包家河金矿地质特征及找矿方向分析	Resource Information and Engineering
陕西省旬阳县家金沟金矿地质特征及找矿标志	Technology Innovation and Application
陕西省柞水县丰北河金矿地质特征及找矿标志研究	中文科技期刊数据库(全文版)自然科学
陕西省柞水县盆儿沟金矿矿床地质特征及找矿规律研究	Scientific and Technological Innovation
陕西石泉北部羊坪湾金矿石英脉流体包裹体特征研究	Geological Review
陕西石泉-旬阳金矿带整装勘查区饶峰幅等7个图幅区1：50000水系沉积物测量原始数据集	Geology in China
陕西双王金矿地球化学特征及其成因分析	Geophysical and Geochemical Exploration
陕西潼关县金矿矿区周边农田土壤重金属生态健康风险评价	Geology in China
陕西小秦岭金矿田石英脉型金矿床石英热释光特征及其找矿意义	Mineral Exploration
陕西小秦岭金矿田太峪金矿区Q154号矿脉构造-蚀变特征及深部找矿预测	矿产勘查
陕西旬阳地区小河金矿硫铅同位素组成及地质意义	Geoscience
陕西旬阳磊石沟金矿矿体地质特征	Technology Innovation and Application
深部矿阶梯找矿方法：以胶东金矿集区深部找矿为例	Geology in China
深部倾斜破碎金矿体高效开采技术研究	金属矿山
深穿透地球化学勘查技术对胶东冲积土覆盖区隐伏金矿的勘查指示	地质学报
石榴石U-Pb定年对山西义兴寨金矿床角砾岩筒时间的限制和金矿成因的指示	Earth Science
石英脉金矿构造特征及控矿分析	China Metal Bulletin
蚀变矿物近红外光谱特征对地质找矿的指示意义——以甘肃岗岔金矿为例	Geological Bulletin of China
世界111个金矿典型矿床地质特征一览	Geology in China
试分析小秦岭金矿田地质构造特征与找矿意义	中文科技期刊数据库(文摘版)工程技术
试析陕西省凤县唐家湾地区金矿地质勘探及预查对策	中文科技期刊数据库(全文版)工程技术
双频激电测量在寻找构造热液银金矿床上的应用研究	Resources Environment & Engineering
双频激电法在澳大利亚Charity Well金矿寻找隐伏矿体的应用	Geology and Exploration
双频激电法在澳大利亚Pilbara地台区寻找盲矿体的应用  ——以Calvert金矿为例	Chinese Journal of Engineering Geophysics
水口山多金属矿床地质特征及金矿找矿标志	中文科技期刊数据库(全文版)自然科学
水系沉积物元素地球化学特征对区域剥蚀程度评价的指示:以青海省东昆仑大场金矿田为例	Bulletin of Geological Science and Technology
水银洞金矿矿床地质特征、成因及找矿标志	Acta Mineralogica Sinica
水银洞金矿与阳山金矿载金矿物成分分析及金的赋存状态	Bulletin of Science and Technology
四川大渡河金矿田辉绿岩的地质特征及意义	Acta Mineralogica Sinica
四川丹巴独狼沟金矿中金与碲铋矿物的赋存状态及金的富集机制	岩石矿物学杂志
四川会东新田金矿矿床地质特征及找矿远景	Geology and Exploration
四川冕宁县马头金矿成矿特征与找矿潜力分析	Contributions to Geology and Mineral Resources Research
四川省郎盖金矿找矿前景浅析	China Metal Bulletin
四川省木里县布昌金矿找矿前景分析	China Metal Bulletin
松坡头金矿成矿机理浅析	中文科技期刊数据库(全文版)自然科学
苏北羽山地区金矿化地质特征及成因分析	中文科技期刊数据库(全文版)自然科学
濉溪县三铺地区金矿赋存状态和矿体成因分析	Resource Information and Engineering
台吉营子金矿矿源层特征及矿体分布规律	China Metal Bulletin
太行山麻棚地区金矿地质特征及找矿前景分析	Geological Review
太行山中段石湖金矿矿体地质特征及同位素成因意义	China Metal Bulletin
滩浅海勘探在三山岛金矿新立矿区海底探测项目的应用	中文科技期刊数据库(全文版)自然科学
郯庐断裂带稳定性特征与区域金矿化化的关系研究	China Metal Bulletin
探析蓬莱初格庄北金矿地质特征	China Metal Bulletin
桃江县陈家村金矿矿床成因及成矿模式探析	Resource Information and Engineering
天峨县加里上金矿地球物化特征及其找矿标志	中国资源综合利用
天水市麦积区刘家坪金矿成矿规律研究	中国资源综合利用
烃汞叠加晕找矿法在湖南沃溪金矿红岩溪矿段勘查中的应用及工程验证	Geophysical and Geochemical Exploration
桐柏—大别造山带麻城地区金矿成矿地质背景及空间展布特征	Resources Environment & Engineering
桐柏老湾金矿带成矿构造体系演化研究及其地质意义	Contributions to Geology and Mineral Resources Research
桐柏山老湾金矿带右行走滑断裂控矿体系的构建及其意义	Geotectonica et Metallogenia
桐柏县老湾金矿找矿实现新突破 金资源量有望超过500吨	资源导刊
铜陵焦冲金矿岩浆作用过程:来自闪长玢岩的证据	Earth Science Frontiers
铜陵杨冲里金矿地质地球化学及年代学研究	Acta Mineralogica Sinica
图古日格日金矿三维地质建模研究	Geological Review
托斯巴斯他乌金矿微量稀土元素地球化学特征及矿床成因分析	Contributions to Geology and Mineral Resources Research
皖南贵溪地区金矿成矿条件及找矿远景分析	现代矿业
皖南朱家坑地区金矿地质及地球物理、地球化学特征	China Metal Bulletin
微细浸染型金矿地质特征及成矿潜力浅析	中文科技期刊数据库(全文版)自然科学
微细浸染状金矿化与脉状金-锑矿化关系：西秦岭阳山金矿带例析	Acta Petrologica Sinica
潍烟铁路金岭金矿埠上矿区金岚沟矿段采空区专项评价	中文科技期刊数据库(文摘版)工程技术
温杖子金矿外围成矿地质条件及找矿前景分析	有色矿冶
文峪金矿周边农田土壤重金属污染特征及生态风险研究	China Metal Bulletin
稳扎基石创新探金——山西省繁峙县山西紫金矿业有限公司金矿勘查荣获中国地质学会2020年度"十大地质找矿成果"	CHINA SCIENCE AND TECHNOLOGY ACHIEVEMENTS
五河县大巩山砂金矿地质特征及成矿规律分析	China Metal Bulletin
五龙金矿三维地质模型建立及找矿预测	China Metal Bulletin
物化探综合找矿方法在吉林杜荒岭金矿勘查中的应用	矿产与地质
物探技术工作方法在金矿找矿中综合应用的分析	China Metal Bulletin
物探技术在金矿勘查中的应用	China Metal Bulletin
西藏班公湖-怒江成矿带南缘鑫龙金矿的发现及意义	矿床地质
西藏地区岩金矿成矿规律探讨	Acta Mineralogica Sinica
西藏多龙矿集区尕尔勤铜金矿砂金矿物学特征及意义	Geological Review
西藏多龙矿集区色那铜金矿地质特征、侵入岩地球化学特征及其地质意义	Acta Mineralogica Sinica
西藏尕尔勤铜金矿多光谱遥感蚀变分带矿物提取	Geology and Exploration
西藏尕尔穷-嘎拉勒铜金矿集区火山岩年代学及地球化学	Earth Science(Journal of China University of Geosciences)
西藏尕尔穷-嘎拉勒铜金矿集区流体包裹体特征及成矿作用研究	Mineral Deposits
西藏尕尔穷铜金矿地球物理勘查模型	Scientific and Technological Management of Land and Resources
西藏尕尔穷铜金矿多光谱遥感地质特征与外围找矿预测	Remote Sensing for Land & Resources
西藏革吉县珠勒地区发现高硫化浅成低温热液铜金矿化类型	中国地质
西藏马扎拉金矿区外围地质特征与找矿方向	Sedimentary Geology and Tethyan Geology
西藏热昌金矿地质及物探化探特征	Mineral Exploration
西岭金矿——中国最大单体金矿	Mineral Exploration
西南三江地区镇沅金矿载金黄铁矿稀土与微量元素特征	Acta Petrologica Sinica
西南天山阿沙哇义金矿床流体包裹体和H-O同位素地球化学特征与造山型金矿成因	中国地质
西秦岭TTG质脉岩地球化学特征及其与金矿化的关系	Science Technology and Engineering
西秦岭大店沟金矿成矿流体演化及矿床成因	Geoscience
西秦岭地区脉岩成因与金成矿关系  ——来自李坝金矿年代学、地球化学及Nd-Hf-S同位素的约束	Mineral Deposits
西秦岭地区猪婆沟金矿成矿物质来源及矿床成因分析	西北地质
西秦岭鄂尔嘎斯地区金矿地球化学特征及找矿潜力分析	中国资源综合利用
西秦岭岗岔金矿赋矿围岩成岩时代及其地质意义	Geoscience
西秦岭花崖沟一带金矿找矿新进展	中国地质调查
西秦岭加甘滩金矿成因研究:毒砂Re-Os定年、载金矿物原位微量元素和硫同位素限定	岩石学报
西秦岭庙沟金矿地质特征及找矿模型	Mineral Exploration
西秦岭岷礼成矿带马坞金矿致矿火成岩组合与成矿地质背景	Geoscience
西秦岭南缘阳山金矿带磷灰石LA-ICP-MS裂变径迹热年代学研究	地质学报
西秦岭阳山金矿带安坝金矿床流体包裹体特征及矿床成因	Geology and Exploration
西秦岭阳山金矿带安坝矿床热液蚀变作用	Acta Petrologica Sinica
西秦岭阳山金矿带成矿热年代学：锆石和磷灰石裂变径迹研究	Earth Science Frontiers
西秦岭阳山金矿带花岗斑岩中独居石的矿物学特征及成因指示	Bulletin of Mineralogy,Petrology and Geochemistry
西秦岭阳山金矿带金矿地质特征及成矿规律研究	Geological Review
西秦岭阳山金矿带控矿因素、找矿标志及深部成矿预测	Mineral Deposits
西秦岭阳山金矿带硫同位素特征：成矿环境与物质来源约束	Acta Petrologica Sinica
西秦岭尹家坪金矿地质特征及矿床成因	Contributions to Geology and Mineral Resources Research
西秦岭早子沟金矿含矿岩体地球化学特征及成因机制探讨	Mineral Exploration
西秦岭早子沟金矿黑云母成分特征及成岩成矿指示意义	岩石矿物学杂志
西秦岭早子沟金矿控矿断裂形成演化	Geotectonica et Metallogenia
西秦岭早子沟金矿中酸性侵入岩地球化学、年代学特征及成矿地质体的确定	岩石矿物学杂志
西秦岭寨上金矿综合地球物理研究	Geological Review
西秦岭左家庄金矿成因研究：来自黄铁矿微量元素及多元同位素地球化学的制约	Earth Science Frontiers
西天山成矿带热液型金矿成矿地质条件及成矿物质来源对比	Geotectonica et Metallogenia
西峡县大庙金矿矿床地质特征及矿床成因浅析	Science & Technology Vision
西准噶尔成矿带金矿异常识别及其不确定性分析	Earth Science
西准噶尔萨吾尔地区黑山头金矿点二长岩锆石U-Pb年代学和地球化学特征: 对成矿前景的指示	Geotectonica et Metallogenia
夏河县完尕金矿地质特征及找矿潜力分析	China Metal Bulletin
湘东北地区合水金矿地质特征及找矿前景分析	China Metal Bulletin
湘东北黄金洞金矿田矿床地质特征成矿规律及找矿新进展	矿产与地质
湘东北仕源金矿地质特征与找矿方向	Resource Information and Engineering
湘东北小坑桥金矿成矿元素地球化学特征研究	Geology and Exploration
湘西符竹溪金矿地质特征及成矿作用	Contributions to Geology and Mineral Resources Research
湘西南阳湾团金矿床雁行金矿带地质特征及成因浅析	China Metal Bulletin
湘西五强溪金矿稀土-微量元素地球化学特征及其成因指示	Chinese Rare Earths
湘中芭蕉冲金矿土壤地球化学特征及找矿前景分析	Geology and Exploration
湘中罗洪—六都寨一带金矿成矿特征研究	China Metal Bulletin
湘中盆地穹隆构造对金矿的控制作用	Resource Information and Engineering
崤山地区金矿成矿物质来源探讨	Mineral Resources and Geology
小秦岭地区遥感线性构造密集带与金矿关系分析及找矿预测	Remote Sensing for Land & Resources
小秦岭金矿矿田构造发育特点及其控矿特征	Journal of Geomechanics
小秦岭金矿田韧性剪切带的控矿规律及中深部成矿分析	Mineral Resources and Geology
小秦岭金矿田三叠纪成矿事件的伸展构造背景：构造岩的40Ar-39Ar年代学证据	Acta Petrologica Sinica
小秦岭金矿田杨砦峪金矿深部矿脉碳-氢-氧同位素特征及其对成矿流体来源的制约	Mineral Resources and Geology
小秦岭西峪–桐峪金矿矿床物质组分及金赋存状态研究	西北地质
新城金矿稳定同位素地球化学特征及成矿物质来源探讨	Geology and Exploration
新疆阿尔金盘龙沟金矿高光谱蚀变矿物找矿标志研究	Contributions to Geology and Mineral Resources Research
新疆阿克陶县切帕勒克金矿地质特征及控制因素浅析	China Metal Bulletin
新疆拜城县阿万达金矿成矿机理分析	China Metal Bulletin
新疆北山白山地区金矿成矿规律及找矿标志分析	中文科技期刊数据库(全文版)自然科学
新疆东天山康古尔金矿黄铁矿热电性与微量元素特征及其地质意义	Geoscience
新疆东准噶尔顿巴斯套金矿地质特征及矿床成因	Geological Review
新疆额尔齐斯金矿带成矿条件及找矿探讨	China Metal Bulletin
新疆富蕴县阿克塔斯金矿化探综合异常与找矿	Mineral Exploration
新疆富蕴县希力库都克金矿矿区地质特征简要分析	China Metal Bulletin
新疆哈密黑山金矿点地质特征及找矿方向	Mineral Exploration
新疆哈密黑山金矿流体包裹体及Pb同位素特征	Mineral Exploration
新疆哈密黑山金矿物化探异常特征及找矿预测	Mineral Exploration
新疆哈密三岔口南金矿地质矿产特征	中文科技期刊数据库(引文版)工程技术
新疆哈密市翠南一带铜金矿地质特征及找矿标志	China Metal Bulletin
新疆哈密市红柳沟金矿地质特征及开采前景分析	中文科技期刊数据库(全文版)自然科学
新疆哈密市野马泉西金矿成因探讨	Mineral Resources and Geology
新疆哈密双鱼山金矿地质地球化学特征及找矿标志	China Metal Bulletin
新疆哈密双鱼山金矿地质特征及成因分析	中文科技期刊数据库(全文版)自然科学
新疆哈图金矿地球化学原生晕的深部找矿意义	Acta Mineralogica Sinica
新疆哈图金矿地质特征及成因浅析	China Metal Bulletin
新疆哈图金矿控矿断裂分布特征及应力分析	China’s Manganese Industry
新疆哈图齐Ⅲ金矿成矿指示元素的分类与深部预测	Acta Mineralogica Sinica
新疆和静县萨很托亥矿区金矿地质特征及找矿潜力评价	China Metal Bulletin
新疆吉勒金矿地质特征及找矿远景	中文科技期刊数据库(全文版)工程技术
新疆金坝金矿成矿作用的地质和流体包裹体证据	Earth Science
新疆青河县库布苏破碎蚀变岩型金矿元素迁移特征与规律研究	Geology and Exploration
新疆若羌县北山地区金矿的找矿规律与成矿预测	China Metal Bulletin
新疆若羌县弧形梁金矿矿床地质特征及成因分析	China Metal Bulletin
新疆塔吾尔别克金矿矿床地质特征及成矿规律探讨	Contributions to Geology and Mineral Resources Research
新疆条形山地区石英脉型金矿地质特征及找矿标志总结	Geological Review
新疆托克逊县可可乃克金矿矿床地质特征及矿床成因类型	中文科技期刊数据库(全文版)自然科学
新疆托克逊县可可乃克金矿矿体特征及找矿标志	China Metal Bulletin
新疆托里县红旗点金矿地质特征及找矿标志	中文科技期刊数据库(全文版)工程技术
新疆乌图顺金矿地质特征及成因研究	China Metal Bulletin
新疆西天山地区金矿成矿条件及发展前景研究	China Metal Bulletin
新疆西天山金矿成矿条件分析及找矿远景	中文科技期刊数据库(全文版)自然科学
新疆西准噶尔金矿成矿规律研究	China Metal Bulletin
新疆伊吾县绿源金矿蚀变带特征及成矿远景分析	中文科技期刊数据库(文摘版)工程技术
新疆于田县苦阿金矿的地质特征及控矿构造研究	China Metal Bulletin
新疆扎格依库都克金矿地质地球化学特征及找矿标志	Mineral Resources and Geology
新开金矿普查区物化探异常特征及应用	China Metal Bulletin
熊耳山上宫金矿稀土元素特征及对金矿物质来源的指示意义	Acta Geoscientia Sinica
雅鲁藏布江缝合带造山型金矿取得突破	China Metal Bulletin
延边地区金矿控矿因素与找矿方向探究	China Metal Bulletin
延边地区九三沟金矿矿石学特征与矿床成因	Geological Review
岩矿石NIR光谱特征与地球化学异常成分之间的关系:以内蒙古朱拉扎嘎金矿为例	Earth Science Frontiers
岩石地球化学测量在甘肃双尖山金矿矿床勘查中的应用	World Nonferrous Metals
岩石热液蚀变作用过程元素的活动性——河南祁雨沟金矿Ⅳ号岩体蚀变花岗斑岩的研究	Acta Petrologica Sinica
岩屑地球化学测量方法在找矿中的应用——以甘肃省瓜州县906金矿为例	World Nonferrous Metals
扬子陆块北缘六冲坪金矿方解石Sm-Nd等时线年龄及其地质意义	Resources Environment & Engineering
阳山金矿成矿流体的He-Ar同位素示踪	Bulletin of Mineralogy,Petrology and Geochemistry
阳山金矿带安坝矿段深部电性结构及地质意义	中国地质调查
阳山金矿带金的赋存状态及其对成矿过程的指示意义	Earth Science Frontiers
瑶坑地区金矿化特征分析及找矿方向	Resource Information and Engineering
一个潜在的超大型构造蚀变岩型金矿——赣西丰山金矿	Acta Mineralogica Sinica
一种新型井中激电装置在铜金矿上的应用	Geophysical and Geochemical Exploration
一种钻孔数据统计与找矿预测新方法 ——以辽宁白云金矿为例	Mineral Exploration
益阳市红星金矿成矿规律与找矿标志研究	Advances in Geosciences
音频大地电磁测深在坦桑尼亚金矿勘查中的应用	Mineral Exploration
音频大地电磁法(AMT)在广西凤山县顶头金矿勘查中的应用	Geology and Exploration
永新金矿闪长玢岩锆石LA-ICP-MS U-Pb定年及地球化学特征	Geological Review
有色冶金矿热电炉碳中和路径设计	有色金属设计
右江沉积盆地印支-燕山期金矿成矿系统研究	Geology and Prospecting
豫陕小秦岭金矿带综合信息成矿预测	地质学刊
豫西萑香洼金矿H-O-S同位素地球化学特征及矿床成因	Mineral Exploration
豫西金矿集区控矿因素分析	Contributions to Geology and Mineral Resources Research
豫西金矿集区矿业活动对周边农田土壤重金属影响研究	岩矿测试
豫西牛头沟金矿土壤地球化学特征及找矿预测	RESOURCES
豫西上宫金矿田地球化学三维特征研究	Mineral Exploration
豫西上宫金矿田断裂构造控矿特征及找矿潜力分析	Mineral Exploration
豫西双河金矿流体包裹体及稳定同位素研究	Acta Petrologica Sinica
豫西嵩县下蒿坪金矿地质特征及矿床成因探讨	Mineral Resources and Geology
豫西崤山地区金矿矿床成因及成矿规律	Advances in Geosciences
豫西崤山地区寺家沟金矿地质特征及成因探讨	China Molybdenum Industry
豫西崤山矿集区金矿成矿地质条件与控矿规律	The Chinese Journal of Nonferrous Metals
豫西小池沟金矿矿床地质特征研究	Mineral Exploration
豫西熊耳山地区北岭金矿Pb、S同位素特征及其地质意义	Geology and Exploration
豫西熊耳山地区槐树坪金矿岩石-土壤找矿指示元素的确定及其应用	Acta Petrologica Sinica
粤北地区鲁古金矿预查及地质特征	China Metal Bulletin
粤西河台金矿田糜棱岩XRD特征及其地质意义	Geological Review
粤西罗镜地区金矿成矿地质背景及找矿潜力	China Metal Bulletin
粤西信宜市盐田坑金矿成矿地质条件及找矿方向	China Metal Bulletin
云南哀牢山金矿带镇沅超大型造山型金矿床碳质物特征及其成矿意义	矿床地质
云南保山浪堆山金矿地质特征及成因浅析	有色矿冶
云南大坪金矿新元古代成矿事件  ——来自热液锆石和闪长岩U-Pb年代学及Hf同位素的约束	Acta Petrologica et Mineralogica
云南富宁地区两期基性岩对者桑金矿成矿贡献——来自年代学制约	Advances in Geosciences
云南富宁两期基性岩地球化学性质与金矿成矿	Acta Mineralogica Sinica
云南广南地区微细粒浸染型金矿成矿条件及找矿潜力	Geology and Exploration
云南金矿地质勘查现状及区域成矿分析	China Metal Bulletin
云南金平县亚拉坡金矿地质特征及成因探讨	中文科技期刊数据库(全文版)自然科学
云南金平长安金矿地球化学障及找矿意义	China Metal Bulletin
云南勐海勐满金矿含金黄铁矿地球化学特征和矿床成因意义	Contributions to Geology and Mineral Resources Research
云南省富源县胜境关金矿矿床特征及找矿标志	Geological Review
云南省香格里拉县红坡金矿地质特征及找矿前景分析	有色矿冶
云南省元阳县大坪金矿外围碳酸盐岩找矿潜力评价	China Metal Bulletin
云南者桑金矿三种矿体成因对比研究	Advances in Geosciences
云南者桑卡林型金矿成矿流体特征及其对Au成矿的指示意义	Bulletin of Mineralogy, Petrology and Geochemistry
云南镇康马鹿街金矿地质特征与成矿分析	China's Manganese Industry
郧西县水田金矿地质特征及成因	中国资源综合利用
造山型金矿成矿流体来源与演化的氢-氧同位素示踪：夹皮沟金矿带例析	Acta Petrologica Sinica
造山型金矿成矿浅析  ——以青海省都兰县诺木洪郭勒地区为例	China Molybdenum Industry
造山型金矿中富CO2高内压流体包裹体完全均一温度的有效测定实验研究 ——以东天山玉峰金矿床为例	Acta Petrologica Sinica
张八岭隆起北段金矿MORPAS证据权重法成矿预测	Contributions to Geology and Mineral Resources Research
张北沟金矿地质特征与找矿方向的技术探讨	中文科技期刊数据库(引文版)工程技术
长安金矿长安矿段露天转地下一期采矿工程安全设施通过现场验收	有色金属设计
长城金矿电阻率异常特征及其找矿意义	矿产勘查
长江中下游成矿带丰山矿田发现新类型金矿——远端浸染型金矿床	Mineral Deposits
长山壕地区金矿航放航磁特征研究	Geophysical and Geochemical Exploration
招远前孙家金矿带控矿模式研究及成矿预测	China Metal Bulletin
找矿突破战略行动十年胶东金矿成矿理论与深部勘查进展	Geological Bulletin of China
浙江诸暨璜山金矿构造特征及深部找矿预测	Geology and Exploration
支持向量机优化算法(SVM)的金矿成矿过程模拟 ——以辽西地区新太古代片麻岩为例	矿产与地质
中国东北部夹皮沟矿集区金矿成矿过程——来自冰湖沟金矿床锆石U-Pb定年和微量元素示踪	吉林大学学报(地球科学版)
中国贵州与美国内华达卡林型金矿对比及对找矿勘查的指示作用	Mineral Deposits
中国金矿成矿地质特征、预测模型及资源潜力	Earth Science Frontiers
中国十大金矿排名	Mineral Exploration
中国造山型金矿及问题思考	Acta Mineralogica Sinica
中亚南天山穆龙套型金矿地质背景、成矿特征和找矿策略	Contributions to Geology and Mineral Resources Research
重力勘探在河南熊耳山地区金矿勘查区找矿预测研究	Mineral Resources and Geology
综合地球物理勘查在低阻覆盖区新疆富蕴县丹坝金矿的应用	China Metal Bulletin
综合电法勘探在西秦岭寨上金矿的应用研究	Geology and Exploration
综合电法在内蒙古赤峰隐伏铜金矿勘查中的应用	Mineral Exploration
综合物化探方法在冀北快活峪一带金矿勘查中的应用	世界有色金属
综合物探方法在覆盖区找矿中的应用  ——以皖东五河金矿整装勘查为例	Geological Survey of China
综合找矿方法在辽宁阜蒙县东五家子金矿勘查中的应用	Geology and Exploration
综合找矿方法在鲁西地区莱芜高家岭金矿勘查中的应用	山东国土资源
佐家庄金矿地质特征及成因探讨	世界有色金属
2009—2019年我国金矿资源勘查形势分析与对策	China Mining Magazine
RS技术在金矿普查勘探中的应用	中文科技期刊数据库(全文版)工程技术
磁法与激电法在铜金矿探查中的应用	中国金属通报
地、物、化综合方法在博故图金矿勘查中的应用	Geophysical and Geochemical Exploration
地电化学集成技术在吉林汪清杜荒岭矿区寻找隐伏金矿研究	FUJIAN ZHILIANG GUANLI
地面高精度磁法在金矿预测工作中的应用	工程技术(全文版)
地质构造对金矿成矿的影响	World Nonferrous Metals
电磁综合测量与金矿普查	中国科技博览
分布式激电测深法在勘查江山金矿中的应用	Energy Technology and Management
关于金矿地质特征及成矿规律的研究	中文科技期刊数据库(全文版)工程技术
关于金矿地质特征及找矿方向	中文科技期刊数据库(全文版)自然科学
广西金矿矿床类型、成矿规律及找矿方向	矿产与地质
华北地区金矿成矿规律及资源潜力	中国地质
华北地台周沿金矿地球化学特征对比	Mineral Resources and Geology
火试金重量法与原子吸收光谱(AAS)法测定砂金矿中金的含量	Chinese Journal of Inorganic Analytical Chemistry
基于ASTER数据韧性剪切带型金矿蚀变信息提取方法优化	Remote Sensing for Land & Resources
基于本体的金矿知识图谱构建方法	地球信息科学学报
胶东金矿成矿模式	Mineral Deposits
胶东型金矿成因模型	中国科学(地球科学)
焦家金矿成矿规律研究	Shandong Industrial Technology
金矿成矿地质特征与成矿规律浅析	中文科技期刊数据库(全文版)自然科学
金矿成矿规律研究与找矿预测	Bulletin of Science and Technology
金矿成矿规律与找矿标志相关研究	中国金属通报
金矿成矿规律与找矿方向分析	World Nonferrous Metals
金矿带地质勘查进展与找矿情况分析	Construction Materials & Decoration
金矿带地质勘查进展与找矿远景	World Nonferrous Metals
金矿地球化学异常特征及异常解译推断	中文科技期刊数据库(全文版)自然科学
金矿地下开采基建探矿应注意的几个问题	世界有色金属
金矿地质勘查现状及找矿方向	中国金属通报
金矿地质勘查现状及找矿方向的探究	中文科技期刊数据库(全文版)自然科学
金矿地质勘查现状及找矿方向分析	中文科技期刊数据库(全文版)自然科学
金矿地质勘查现状及找矿方向探讨	World Nonferrous Metals
金矿地质勘查现状及找矿方向探析	中文科技期刊数据库(全文版)工程技术
金矿地质勘查现状及找矿方向研究	中国金属通报
金矿地质特点与成矿规律探究	World Nonferrous Metals
金矿地质特点与成矿规律微探	World Nonferrous Metals
金矿地质特点与成矿规律研究分析	世界有色金属
金矿地质特征、矿床成因及找矿标志和对策	自然科学(全文版)
金矿地质特征和找矿前景探讨	east china science & technology
金矿地质特征及成矿规律	工程技术(全文版)
金矿地质特征及成矿规律分析	世界有色金属
金矿地质特征及成矿规律研究分析	中国金属通报
金矿地质特征及找矿方向研究	中国金属通报
金矿地质找矿技术分析与创新	中文科技期刊数据库(文摘版)工程技术
金矿地质找矿勘查技术的趋势与发展	中文科技期刊数据库(全文版)自然科学
金矿地质找矿勘查技术的趋势与发展探讨	中文科技期刊数据库(文摘版)工程技术
金矿地质找矿新技术、新方法应用及开发	中文科技期刊数据库(全文版)自然科学
金矿的地质特征及找矿标志研究分析	24721
金矿的样品制备与分析方法研究进展	世界有色金属
金矿等战略性矿产资源勘查成果	中国科技成果
金矿等战略性矿产资源勘查分析	世界有色金属
金矿复杂地层深部地质钻探的钻孔结构设计	World Nonferrous Metals
金矿开采安全管理问题探析及防护措施	世界有色金属
金矿开采中连续开采关键技术改进研究	World Nonferrous Metals
金矿勘查技术创新与找矿突破分析	中国金属通报
金矿勘查中地球物理勘探方法的应用分析	World Nonferrous Metals
金矿勘查中地球物理探矿方法的应用优势与对策	世界有色金属
金矿矿床地质特征及矿床成因分析	China Science & Technology Panorama Magazine
金矿矿床地质特征及原因探析	中文科技期刊数据库(全文版)自然科学
金矿矿床地质特征与矿床成因的相关研究	World Nonferrous Metals
金矿矿床地质特征与矿床成因分析	中国金属通报
金矿矿物岩石特征及矿床成因探析	World Nonferrous Metals
金矿田深部找矿预测与找矿理论	世界有色金属
金矿田深部找矿预测与找矿理论探究	World Nonferrous Metals
金矿找矿勘查工作要点探索	中文科技期刊数据库(全文版)工程技术
金矿找矿中勘查技术的应用及常见问题分析	中文科技期刊数据库(文摘版)工程技术
金矿找矿中勘查技术应用存在的问题及建议	中国金属通报
金矿找矿中勘察技术的应用及问题探讨	China Science & Technology Panorama Magazine
金矿中黄铁矿标型特征及成因意义	FUJIAN ZHILIANG GUANLI
金矿中金的测试分析试验设计与分析	Metallurgy and Materials
机械采矿技术在新城金矿倾斜厚重矿体开采中的运用	山东黄金集团股份有限公司新城金矿
充气式浮选机在某高原金矿选厂浮选中的应用	Qinghai Engineering Research Center for Gold Resources Development	
青海省第六地质矿产勘查院；青海省金矿资源开发工程技术研究中心
卡林型金矿的特征研究	FUJIAN ZHILIANG GUANLI
卡林型金矿研究进展	FUJIAN ZHILIANG GUANLI
砾岩型金矿研究进展	Western Resources
流体包裹体在深部找矿预测中的应用研究  ——以广西隆安县雷耀岭金矿为例	China Metal Bulletin
浅成低温热液型金矿研究综述	Contributions to Geology and Mineral Resources Research
浅论便携式X荧光光谱分析仪在金矿勘查中的应用	中文科技期刊数据库(全文版)工程技术
浅谈地球物理勘查技术在金矿勘探中的应用	中国科技期刊数据库 工业A
浅谈金矿地质找矿勘查技术的趋势与发展	中文科技期刊数据库(文摘版)工程技术
浅谈金矿勘查技术的趋势与发展	World Nonferrous Metals
浅谈金矿勘查中地球物理探矿方法的应用与发展	中文科技期刊数据库(全文版)自然科学
浅谈金矿找矿中构造成矿理论的应用	World Nonferrous Metals
浅谈我国金矿资源现状	World Nonferrous Metals
青海金矿成矿规律及找矿方向	Journal of Earth Sciences and Environment
区域岩浆热液成矿的数值模拟  ——以熊耳山前河地区金矿为例	Journal of University of Chinese Academy of Sciences
热液金矿成矿元素运移和沉淀机理研究综述	Geological Science and Technology Information
热液金矿中辉锑矿矿物学研究综述	Acta Geologica Sichuan
人工重砂在蚀变岩金矿勘查中的应用——以宁夏树龙沟金矿为例	Geotectonica et Metallogenia
山东金矿找矿突破进展与前景	Acta Geologica Sinica
深部金矿成矿规律和找矿前景研究	Science & Technology Industry Parks
深部金矿资源勘查因素及找矿前景分析	世界有色金属
微波消解ICP-MS 在测定低品位金矿多种元素中的应用研究	China Metal Bulletin
我国金矿地质特征及矿床成因	World Nonferrous Metals
我国金矿地质特征及找矿方向分析	China Southern Agricultural Machinery
我国金矿地质现状、区域成矿及找矿	World Nonferrous Metals
我国金矿资源概况及选冶技术研究进展	矿产综合利用
我国金矿资源前景与分析	World Nonferrous Metals
我国金矿资源与地质勘查形势的初步探讨	Shandong Industrial Technology
我国金矿资源与地质勘查形势的初步研究	China Metal Bulletin
我国热液金矿中黄铁矿的载金性研究	Geoscience
西天山金矿成矿类型探讨	China Metal Bulletin
小秦岭金矿田金成矿规律分析	河南科技
造山型金矿的地质特征和成矿流体	Geotectonica et Metallogenia
造山型金矿的流体包裹体特征	FUJIAN ZHILIANG GUANLI
造山型金矿构造控矿作用	岩石学报
造山型金矿容矿建造分类、成矿模式及找矿勘查	地质学报
造山型金矿是如何形成的？	地球科学
造山型金矿研究进展：兼论中国造山型金成矿作用	Earth Science
中国金矿集区及其资源潜力探讨	中国地质
中国金矿资源的现状及前景分析	China Metal Bulletin
中国金矿资源特征及成矿规律概要	中国金属通报
中国金矿资源特征及勘查方向概述	中文科技期刊数据库(全文版)自然科学
综合地球物理探测在金矿预测中的应用 ——以胶东郑家金矿为例	中国地质调查
综合电法在金矿勘探中的应用	Energy Technology and Management
